0101001010
0000000000
0000000000
0011001100
0011001100
00E000E000
1000110001
11E0000011
1100000011
111011B111