0111111111
0001111111
0000011111
1111001111
1111011110
11110E1111
1111100011
1111111010
1111000010
1111111111