0000000000
0000010000
0000111100
0001010010
0001010000
0000111000
000001010E
0010010100
0001111000 
0000010000