0001010000
0001010110
011101011E
0000000000
1111E11110
0101000010
0101011010
0E00011010
0111000010
000101101B