1001010000
0001010110
0111010110
0000000000
1111011110
0101000010
0101011010
0000011010
0111000010
0001011010